#########
#**#****#
#**#*#*##
#******##
##***####
#**#**###
##**#***#
#*#*#*#*#
#########